1111111111111111111
5555555555555555555
7777777777777777777
0000000000000000000
4444444444444444444
8888888888888888888
