1111111111111111111
3333333333333333333
5555555555555555555
6666666666666666666
8888888888888888888
9999999999999999999
0000000000000000000
