1111111111111111111
3333333333333333333
5555555555555555555
7777777777777777777
9999999999999999999
0000000000000000000
2222222222222222222
4444444444444444444
6666666666666666666
8888888888888888888
