0000000000000000000000000
0000000000000000000000000
0000606060606060606060000
0000060606060606060600000
0000050505050505050500000
0000404040505040404040000
0000030303030303030300000
0000021202120212021200000
0000000000000000000000000
0000000000000000000000000
0000000000000000000000000
0000000000000000000000000
0000000000000000000000000
0000000000000000000000000
0000000000000000000000000
0000000000000000000000000
0007000700070700070007000
0000000000000000000000000
0000000000000000000000000
0000000000000000000000000
