0000000000000000000000000
0000304050601060504030000
0000102010201020102010000
0000021212121212121200000
0000000000000000000000000
0000000000000000000000000
0000000000000000000000000
0000000000000000000000000
0000000000000000000000000
0000000000000000000000000
0000000000000000000000000
0000000000000000000000000
0000000000000000000000000
0000000000000000000000000
0000000000000000000000000
0000000000000000000000000
0007000700070700070007000
0000000000000000000000000
0000000000000000000000000
0000000000000000000000000
