0000000000000000000000000
0000102010201020102010000
0000021212121212121200000
0000000000000000000000000
0000000000000000000000000
0000000000000000000000000
0000000000000000000000000
0000000000000000000000000
0000000000000000000000000
0000000000000000000000000
0000000000000000000000000
0000000000000000000000000
0000000000000000000000000
0000000000000000000000000
0000000000000000000000000
0000000000000000000000000
0707000700007000070007070
0000000000000000000000000
0000000000000000000000000
0000000000000000000000000
