0000000000000000000000000
0000605050506050505060000
0000404040505040404040000
0000030303030303030300000
0000021202120212021200000
0000000000000000000000000
0000000000000000000000000
0000000000000000000000000
0000000000000000000000000
0000000000000000000000000
0000000000000000000000000
0000000000000000000000000
0000000000000000000000000
0000000000000000000000000
0000000000000000000000000
0000000000000000000000000
0007000700070700070007000
0000000000000000000000000
0000000000000000000000000
0000000000000000000000000
