0000050505050505050500000
0000404040505040404040000
0000606060606060606060000
0000060606060606060600000
0000050505050505050500000
0000404040505040404040000
0000606060606060606060000
0000060606060606060600000
0001111111111111111111000
0000000000000000000000000
0000000000000000000000000
0000000000000000000000000
0000000000000000000000000
0000000000000000000000000
0000000000000000000000000
0000000000000000000000000
0007000700070700070007000
0000000000000000000000000
0000000000000000000000000
0000000000000000000000000
